"Età","Celibi","Coniugati","Divorziati","Vedovi","Uniti civilmente","Maschi già in unione civile (per scioglimento unione)","Maschi già in unione civile (per decesso del partner)","Totale maschi","Nubili","Coniugate","Divorziate","Vedove","Unite civilmente","Femmine già in unione civile (per scioglimento unione)","Femmine già in unione civile (per decesso del partner)","Totale femmine","Totale"
"0","5133","0","0","0","0","0","0","5133","4820","0","0","0","0","0","0","4820","9953"
"1","5054","0","0","0","0","0","0","5054","4763","0","0","0","0","0","0","4763","9817"
"2","5222","0","0","0","0","0","0","5222","4908","0","0","0","0","0","0","4908","10130"
"3","5437","0","0","0","0","0","0","5437","5200","0","0","0","0","0","0","5200","10637"
"4","5558","0","0","0","0","0","0","5558","5288","0","0","0","0","0","0","5288","10846"
"5","5765","0","0","0","0","0","0","5765","5392","0","0","0","0","0","0","5392","11157"
"6","5807","0","0","0","0","0","0","5807","5359","0","0","0","0","0","0","5359","11166"
"7","5840","0","0","0","0","0","0","5840","5594","0","0","0","0","0","0","5594","11434"
"8","5910","0","0","0","0","0","0","5910","5478","0","0","0","0","0","0","5478","11388"
"9","6090","0","0","0","0","0","0","6090","5547","0","0","0","0","0","0","5547","11637"
"10","5966","0","0","0","0","0","0","5966","5652","0","0","0","0","0","0","5652","11618"
"11","6204","0","0","0","0","0","0","6204","5676","0","0","0","0","0","0","5676","11880"
"12","6207","0","0","0","0","0","0","6207","5960","0","0","0","0","0","0","5960","12167"
"13","6358","0","0","0","0","0","0","6358","5935","0","0","0","0","0","0","5935","12293"
"14","6293","0","0","0","0","0","0","6293","5863","0","0","0","0","0","0","5863","12156"
"15","6335","0","0","0","0","0","0","6335","5891","0","0","0","0","0","0","5891","12226"
"16","6073","0","0","0","0","0","0","6073","5587","1","0","0","0","0","0","5588","11661"
"17","6182","0","0","0","0","0","0","6182","5807","0","0","0","0","0","0","5807","11989"
"18","6169","0","0","0","0","0","0","6169","5523","1","0","0","0","0","0","5524","11693"
"19","6262","0","0","0","0","0","0","6262","5462","3","0","0","0","0","0","5465","11727"
"20","6195","1","0","0","1","0","0","6197","5603","17","0","0","0","0","0","5620","11817"
"21","6679","3","0","0","0","0","0","6682","5722","63","1","0","1","0","0","5787","12469"
"22","6901","15","2","0","1","0","0","6919","5513","91","0","1","0","0","0","5605","12524"
"23","7125","28","0","0","0","0","0","7153","5745","158","1","0","0","0","0","5904","13057"
"24","6924","48","1","0","2","0","0","6975","5825","215","3","0","1","0","0","6044","13019"
"25","7072","101","1","0","8","1","0","7183","6066","343","10","0","0","0","0","6419","13602"
"26","7201","159","3","0","8","0","0","7371","6281","483","7","2","3","0","0","6776","14147"
"27","7510","237","3","0","7","0","0","7757","6755","690","10","4","3","0","0","7462","15219"
"28","7710","389","5","0","10","0","0","8114","6983","872","14","2","4","0","0","7875","15989"
"29","8043","582","8","1","15","1","0","8650","7033","1222","33","4","3","0","0","8295","16945"
"30","7895","822","12","1","17","0","0","8747","7002","1601","37","7","3","0","0","8650","17397"
"31","8093","1128","20","1","29","1","0","9272","6787","2066","41","2","7","0","0","8903","18175"
"32","7853","1533","31","1","26","2","0","9446","6567","2492","60","5","6","2","0","9132","18578"
"33","7658","1876","36","2","33","1","0","9606","6067","2933","84","5","22","0","0","9111","18717"
"34","6848","2302","50","1","35","1","0","9237","5250","3398","103","6","20","2","0","8779","18016"
"35","6418","2794","56","1","40","1","1","9311","4905","3658","151","11","14","1","0","8740","18051"
"36","6165","3111","101","2","45","0","0","9424","4652","3991","178","7","15","1","0","8844","18268"
"37","5734","3513","120","3","32","1","0","9403","4430","4270","196","11","20","4","0","8931","18334"
"38","5454","3934","135","1","52","1","0","9577","4281","4570","233","26","13","1","0","9124","18701"
"39","5342","4265","135","7","43","1","0","9793","4174","4910","281","36","19","2","0","9422","19215"
"40","4983","4511","182","3","37","2","0","9718","3895","4890","303","36","18","2","0","9144","18862"
"41","4755","4468","201","8","37","0","0","9469","3661","4801","332","30","20","0","1","8845","18314"
"42","4447","4682","216","15","55","1","0","9416","3491","5141","369","39","18","1","0","9059","18475"
"43","4416","4933","250","10","36","0","0","9645","3499","5165","395","44","16","2","0","9121","18766"
"44","4257","5134","269","9","51","2","1","9723","3624","5473","436","59","27","1","0","9620","19343"
"45","4325","5170","325","19","39","1","0","9879","3576","5642","517","64","19","2","1","9821","19700"
"46","4308","5564","349","32","42","1","2","10298","3635","6019","619","71","10","0","0","10354","20652"
"47","4408","5856","445","32","61","0","1","10803","3793","6393","641","88","15","0","0","10930","21733"
"48","4320","6246","431","34","50","1","0","11082","3717","6527","779","109","9","2","0","11143","22225"
"49","4006","6207","484","34","56","1","0","10788","3584","6811","883","106","14","1","0","11399","22187"
"50","3926","6603","579","40","54","1","1","11204","3316","6983","916","152","24","1","0","11392","22596"
"51","3616","6510","575","52","61","0","4","10818","3153","6843","1027","171","12","2","0","11208","22026"
"52","3403","6718","739","51","55","0","0","10966","3050","6952","1040","174","11","0","0","11227","22193"
"53","3190","6794","670","47","57","0","1","10759","2809","6854","1094","222","18","1","0","10998","21757"
"54","3072","6545","749","53","42","1","1","10463","2732","6850","1092","262","16","0","0","10952","21415"
"55","3091","6647","774","94","54","0","0","10660","2558","7031","1217","294","14","0","0","11114","21774"
"56","2805","6805","845","81","48","0","1","10585","2524","6844","1214","348","17","0","0","10947","21532"
"57","2505","6833","845","105","49","1","1","10339","2439","6643","1297","353","12","1","0","10745","21084"
"58","2147","6440","811","99","53","0","3","9553","2100","6594","1218","357","10","0","0","10279","19832"
"59","1855","6019","850","119","51","0","0","8894","1937","6077","1182","448","11","0","0","9655","18549"
"60","1819","5833","756","93","51","0","3","8555","1775","5916","1110","469","8","0","0","9278","17833"
"61","1534","5621","679","134","26","0","1","7995","1671","5555","1056","535","15","0","0","8832","16827"
"62","1365","5385","667","133","36","0","1","7587","1471","5435","1077","568","7","0","1","8559","16146"
"63","1307","5224","630","137","38","1","1","7338","1337","5086","931","559","5","0","2","7920","15258"
"64","1092","5092","590","139","22","0","0","6935","1308","5028","982","618","7","0","0","7943","14878"
"65","1073","4830","596","175","16","0","3","6693","1170","4739","923","716","6","0","0","7554","14247"
"66","860","4628","535","161","20","1","0","6205","1019","4657","905","806","6","0","0","7393","13598"
"67","818","4610","525","200","18","0","1","6172","1001","4348","797","883","5","0","0","7034","13206"
"68","743","4223","441","215","17","0","1","5640","887","4215","789","912","2","0","0","6805","12445"
"69","725","4192","426","194","27","1","0","5565","886","4120","758","939","6","0","0","6709","12274"
"70","661","3987","405","254","13","0","2","5322","806","4079","776","1102","6","0","0","6769","12091"
"71","611","4039","376","292","8","0","0","5326","779","4211","700","1267","2","0","0","6959","12285"
"72","594","4171","344","291","18","0","1","5419","833","4226","706","1423","4","0","0","7192","12611"
"73","547","4477","380","391","22","0","0","5817","800","4438","720","1669","4","0","0","7631","13448"
"74","557","4481","338","417","18","0","2","5813","763","4605","759","1915","2","0","0","8044","13857"
"75","535","4828","359","527","10","0","0","6259","804","4636","755","2200","2","0","0","8397","14656"
"76","369","3561","276","382","4","0","0","4592","601","3276","504","1869","0","0","0","6250","10842"
"77","399","3772","217","437","12","0","0","4837","621","3441","543","2179","0","0","0","6784","11621"
"78","331","3631","233","478","6","1","1","4681","640","3418","483","2326","1","0","0","6868","11549"
"79","369","3500","196","505","7","0","0","4577","612","3158","484","2602","1","0","0","6857","11434"
"80","288","3475","188","641","6","0","1","4599","608","2972","446","2899","0","0","0","6925","11524"
"81","323","3786","205","674","5","0","0","4993","633","2984","421","3340","0","0","0","7378","12371"
"82","277","3461","150","747","7","0","0","4642","644","2785","368","3355","1","0","0","7153","11795"
"83","225","3281","136","760","3","0","0","4405","617","2403","356","3513","0","0","0","6889","11294"
"84","184","2717","101","715","8","0","0","3725","512","1898","257","3476","0","0","0","6143","9868"
"85","151","2284","79","649","2","0","0","3165","454","1479","255","3226","1","0","0","5415","8580"
"86","142","2077","71","639","0","0","0","2929","443","1276","201","3372","0","0","0","5292","8221"
"87","137","1791","60","649","2","0","0","2639","455","1008","185","3217","1","0","0","4866","7505"
"88","99","1454","46","591","4","0","0","2194","394","757","146","2970","0","0","1","4268","6462"
"89","101","1290","38","515","2","0","0","1946","377","566","140","2712","0","0","0","3795","5741"
"90","54","991","26","498","3","0","0","1572","349","435","92","2522","0","0","0","3398","4970"
"91","39","807","30","426","2","0","1","1305","315","336","108","2377","0","0","0","3136","4441"
"92","43","586","20","346","0","0","0","995","228","234","61","1965","0","0","0","2488","3483"
"93","28","383","7","271","1","0","0","690","196","130","53","1533","0","0","0","1912","2602"
"94","20","258","11","220","0","0","0","509","162","77","37","1237","0","0","0","1513","2022"
"95","22","154","3","179","0","0","0","358","109","54","30","1012","0","0","0","1205","1563"
"96","11","113","6","106","0","0","0","236","83","42","19","760","0","0","0","904","1140"
"97","6","51","0","93","0","0","0","150","70","18","18","540","0","0","0","646","796"
"98","10","34","1","61","0","0","0","106","55","13","7","415","0","0","0","490","596"
"99","1","26","0","43","0","0","0","70","35","4","8","290","0","0","0","337","407"
"100 e oltre","3","21","1","48","0","0","0","73","58","11","10","461","0","0","0","540","613"
"Totale","348993","264651","21456","15384","1826","27","36","652373","315020","270650","36990","74305","557","29","6","697557","1349930"